[console_scripts]
csv2cve = cve_bin_tool.csv2cve:main
cve-bin-tool = cve_bin_tool.cli:main

[cve_bin_tool.checker]
accountsservice = cve_bin_tool.checkers.accountsservice:AccountsserviceChecker
acpid = cve_bin_tool.checkers.acpid:AcpidChecker
apache_http_server = cve_bin_tool.checkers.apache_http_server:ApacheHttpServerChecker
apcupsd = cve_bin_tool.checkers.apcupsd:ApcupsdChecker
asn1c = cve_bin_tool.checkers.asn1c:Asn1CChecker
assimp = cve_bin_tool.checkers.assimp:AssimpChecker
asterisk = cve_bin_tool.checkers.asterisk:AsteriskChecker
atftp = cve_bin_tool.checkers.atftp:AtftpChecker
avahi = cve_bin_tool.checkers.avahi:AvahiChecker
bash = cve_bin_tool.checkers.bash:BashChecker
bind = cve_bin_tool.checkers.bind:BindChecker
binutils = cve_bin_tool.checkers.binutils:BinutilsChecker
bird = cve_bin_tool.checkers.bird:BirdChecker
bison = cve_bin_tool.checkers.bison:BisonChecker
boinc = cve_bin_tool.checkers.boinc:BoincChecker
bolt = cve_bin_tool.checkers.bolt:BoltChecker
bro = cve_bin_tool.checkers.bro:BroChecker
bubblewrap = cve_bin_tool.checkers.bubblewrap:BubblewrapChecker
busybox = cve_bin_tool.checkers.busybox:BusyboxChecker
bzip2 = cve_bin_tool.checkers.bzip2:Bzip2Checker
c_ares = cve_bin_tool.checkers.c_ares:CAresChecker
chess = cve_bin_tool.checkers.chess:ChessChecker
chrony = cve_bin_tool.checkers.chrony:ChronyChecker
clamav = cve_bin_tool.checkers.clamav:ClamavChecker
collectd = cve_bin_tool.checkers.collectd:CollectdChecker
commons_compress = cve_bin_tool.checkers.commons_compress:CommonsCompressChecker
connman = cve_bin_tool.checkers.connman:ConnmanChecker
cronie = cve_bin_tool.checkers.cronie:CronieChecker
cryptsetup = cve_bin_tool.checkers.cryptsetup:CryptsetupChecker
cups = cve_bin_tool.checkers.cups:CupsChecker
curl = cve_bin_tool.checkers.curl:CurlChecker
cvs = cve_bin_tool.checkers.cvs:CvsChecker
darkhttpd = cve_bin_tool.checkers.darkhttpd:DarkhttpdChecker
davfs2 = cve_bin_tool.checkers.davfs2:Davfs2Checker
dbus = cve_bin_tool.checkers.dbus:DbusChecker
dhcpcd = cve_bin_tool.checkers.dhcpcd:DhcpcdChecker
dnsmasq = cve_bin_tool.checkers.dnsmasq:DnsmasqChecker
domoticz = cve_bin_tool.checkers.domoticz:DomoticzChecker
dovecot = cve_bin_tool.checkers.dovecot:DovecotChecker
dpkg = cve_bin_tool.checkers.dpkg:DpkgChecker
e2fsprogs = cve_bin_tool.checkers.e2fsprogs:E2FsprogsChecker
elfutils = cve_bin_tool.checkers.elfutils:ElfutilsChecker
enscript = cve_bin_tool.checkers.enscript:EnscriptChecker
exim = cve_bin_tool.checkers.exim:EximChecker
exiv2 = cve_bin_tool.checkers.exiv2:Exiv2Checker
expat = cve_bin_tool.checkers.expat:ExpatChecker
fastd = cve_bin_tool.checkers.fastd:FastdChecker
ffmpeg = cve_bin_tool.checkers.ffmpeg:FfmpegChecker
file = cve_bin_tool.checkers.file:FileChecker
firefox = cve_bin_tool.checkers.firefox:FirefoxChecker
freeradius = cve_bin_tool.checkers.freeradius:FreeradiusChecker
freerdp = cve_bin_tool.checkers.freerdp:FreerdpChecker
fribidi = cve_bin_tool.checkers.fribidi:FribidiChecker
ftp = cve_bin_tool.checkers.ftp:FtpChecker
gcc = cve_bin_tool.checkers.gcc:GccChecker
gdb = cve_bin_tool.checkers.gdb:GdbChecker
gimp = cve_bin_tool.checkers.gimp:GimpChecker
git = cve_bin_tool.checkers.git:GitChecker
glib = cve_bin_tool.checkers.glib:GlibChecker
glibc = cve_bin_tool.checkers.glibc:GlibcChecker
gmp = cve_bin_tool.checkers.gmp:GmpChecker
gnomeshell = cve_bin_tool.checkers.gnomeshell:GnomeshellChecker
gnupg = cve_bin_tool.checkers.gnupg:GnupgChecker
gnutls = cve_bin_tool.checkers.gnutls:GnutlsChecker
gpgme = cve_bin_tool.checkers.gpgme:GpgmeChecker
gpsd = cve_bin_tool.checkers.gpsd:GpsdChecker
graphicsmagick = cve_bin_tool.checkers.graphicsmagick:GraphicsmagickChecker
grub2 = cve_bin_tool.checkers.grub2:Grub2Checker
gstreamer = cve_bin_tool.checkers.gstreamer:GstreamerChecker
gupnp = cve_bin_tool.checkers.gupnp:GupnpChecker
gvfs = cve_bin_tool.checkers.gvfs:GvfsChecker
haproxy = cve_bin_tool.checkers.haproxy:HaproxyChecker
haserl = cve_bin_tool.checkers.haserl:HaserlChecker
hdf5 = cve_bin_tool.checkers.hdf5:Hdf5Checker
hostapd = cve_bin_tool.checkers.hostapd:HostapdChecker
hunspell = cve_bin_tool.checkers.hunspell:HunspellChecker
i2pd = cve_bin_tool.checkers.i2pd:I2PdChecker
icecast = cve_bin_tool.checkers.icecast:IcecastChecker
icu = cve_bin_tool.checkers.icu:IcuChecker
iperf3 = cve_bin_tool.checkers.iperf3:Iperf3Checker
ipsec_tools = cve_bin_tool.checkers.ipsec_tools:IpsecToolsChecker
iptables = cve_bin_tool.checkers.iptables:IptablesChecker
irssi = cve_bin_tool.checkers.irssi:IrssiChecker
iucode_tool = cve_bin_tool.checkers.iucode_tool:IucodeToolChecker
jack2 = cve_bin_tool.checkers.jack2:Jack2Checker
jacksondatabind = cve_bin_tool.checkers.jacksondatabind:JacksondatabindChecker
janus = cve_bin_tool.checkers.janus:JanusChecker
jhead = cve_bin_tool.checkers.jhead:JheadChecker
json_c = cve_bin_tool.checkers.json_c:JsonCChecker
kbd = cve_bin_tool.checkers.kbd:KbdChecker
keepalived = cve_bin_tool.checkers.keepalived:KeepalivedChecker
kerberos = cve_bin_tool.checkers.kerberos:KerberosChecker
kexectools = cve_bin_tool.checkers.kexectools:KexectoolsChecker
lftp = cve_bin_tool.checkers.lftp:LftpChecker
libarchive = cve_bin_tool.checkers.libarchive:LibarchiveChecker
libbpg = cve_bin_tool.checkers.libbpg:LibbpgChecker
libconfuse = cve_bin_tool.checkers.libconfuse:LibconfuseChecker
libdb = cve_bin_tool.checkers.libdb:LibdbChecker
libebml = cve_bin_tool.checkers.libebml:LibebmlChecker
libgcrypt = cve_bin_tool.checkers.libgcrypt:LibgcryptChecker
libgit2 = cve_bin_tool.checkers.libgit2:Libgit2Checker
libical = cve_bin_tool.checkers.libical:LibicalChecker
libinput = cve_bin_tool.checkers.libinput:LibinputChecker
libjpeg = cve_bin_tool.checkers.libjpeg:LibjpegChecker
libjpeg_turbo = cve_bin_tool.checkers.libjpeg_turbo:LibjpegTurboChecker
libksba = cve_bin_tool.checkers.libksba:LibksbaChecker
liblas = cve_bin_tool.checkers.liblas:LiblasChecker
libnss = cve_bin_tool.checkers.libnss:LibnssChecker
libpcap = cve_bin_tool.checkers.libpcap:LibpcapChecker
librsvg = cve_bin_tool.checkers.librsvg:LibrsvgChecker
librsync = cve_bin_tool.checkers.librsync:LibrsyncChecker
libsamplerate = cve_bin_tool.checkers.libsamplerate:LibsamplerateChecker
libseccomp = cve_bin_tool.checkers.libseccomp:LibseccompChecker
libsndfile = cve_bin_tool.checkers.libsndfile:LibsndfileChecker
libsolv = cve_bin_tool.checkers.libsolv:LibsolvChecker
libsoup = cve_bin_tool.checkers.libsoup:LibsoupChecker
libsrtp = cve_bin_tool.checkers.libsrtp:LibsrtpChecker
libssh = cve_bin_tool.checkers.libssh:LibsshChecker
libssh2 = cve_bin_tool.checkers.libssh2:Libssh2Checker
libtiff = cve_bin_tool.checkers.libtiff:LibtiffChecker
libtomcrypt = cve_bin_tool.checkers.libtomcrypt:LibtomcryptChecker
libupnp = cve_bin_tool.checkers.libupnp:LibupnpChecker
libvirt = cve_bin_tool.checkers.libvirt:LibvirtChecker
libvncserver = cve_bin_tool.checkers.libvncserver:LibvncserverChecker
libvorbis = cve_bin_tool.checkers.libvorbis:LibvorbisChecker
libxslt = cve_bin_tool.checkers.libxslt:LibxsltChecker
lighttpd = cve_bin_tool.checkers.lighttpd:LighttpdChecker
lldpd = cve_bin_tool.checkers.lldpd:LldpdChecker
logrotate = cve_bin_tool.checkers.logrotate:LogrotateChecker
lua = cve_bin_tool.checkers.lua:LuaChecker
luajit = cve_bin_tool.checkers.luajit:LuajitChecker
lynx = cve_bin_tool.checkers.lynx:LynxChecker
lz4 = cve_bin_tool.checkers.lz4:Lz4Checker
mailx = cve_bin_tool.checkers.mailx:MailxChecker
mariadb = cve_bin_tool.checkers.mariadb:MariadbChecker
mdadm = cve_bin_tool.checkers.mdadm:MdadmChecker
memcached = cve_bin_tool.checkers.memcached:MemcachedChecker
minicom = cve_bin_tool.checkers.minicom:MinicomChecker
minidlna = cve_bin_tool.checkers.minidlna:MinidlnaChecker
miniupnpc = cve_bin_tool.checkers.miniupnpc:MiniupnpcChecker
miniupnpd = cve_bin_tool.checkers.miniupnpd:MiniupnpdChecker
mosquitto = cve_bin_tool.checkers.mosquitto:MosquittoChecker
motion = cve_bin_tool.checkers.motion:MotionChecker
mpv = cve_bin_tool.checkers.mpv:MpvChecker
mtr = cve_bin_tool.checkers.mtr:MtrChecker
mutt = cve_bin_tool.checkers.mutt:MuttChecker
mysql = cve_bin_tool.checkers.mysql:MysqlChecker
nano = cve_bin_tool.checkers.nano:NanoChecker
nbd = cve_bin_tool.checkers.nbd:NbdChecker
ncurses = cve_bin_tool.checkers.ncurses:NcursesChecker
neon = cve_bin_tool.checkers.neon:NeonChecker
nessus = cve_bin_tool.checkers.nessus:NessusChecker
netatalk = cve_bin_tool.checkers.netatalk:NetatalkChecker
netpbm = cve_bin_tool.checkers.netpbm:NetpbmChecker
nettle = cve_bin_tool.checkers.nettle:NettleChecker
nghttp2 = cve_bin_tool.checkers.nghttp2:Nghttp2Checker
nginx = cve_bin_tool.checkers.nginx:NginxChecker
nmap = cve_bin_tool.checkers.nmap:NmapChecker
node = cve_bin_tool.checkers.node:NodeChecker
ntp = cve_bin_tool.checkers.ntp:NtpChecker
ntpsec = cve_bin_tool.checkers.ntpsec:NtpsecChecker
open_vm_tools = cve_bin_tool.checkers.open_vm_tools:OpenVmToolsChecker
openafs = cve_bin_tool.checkers.openafs:OpenafsChecker
opencv = cve_bin_tool.checkers.opencv:OpencvChecker
openjpeg = cve_bin_tool.checkers.openjpeg:OpenjpegChecker
openldap = cve_bin_tool.checkers.openldap:OpenldapChecker
openssh = cve_bin_tool.checkers.openssh:OpensshChecker
openssl = cve_bin_tool.checkers.openssl:OpensslChecker
openswan = cve_bin_tool.checkers.openswan:OpenswanChecker
openvpn = cve_bin_tool.checkers.openvpn:OpenvpnChecker
p7zip = cve_bin_tool.checkers.p7zip:P7ZipChecker
pango = cve_bin_tool.checkers.pango:PangoChecker
patch = cve_bin_tool.checkers.patch:PatchChecker
pcsc_lite = cve_bin_tool.checkers.pcsc_lite:PcscLiteChecker
perl = cve_bin_tool.checkers.perl:PerlChecker
pigz = cve_bin_tool.checkers.pigz:PigzChecker
png = cve_bin_tool.checkers.png:PngChecker
polarssl_fedora = cve_bin_tool.checkers.polarssl_fedora:PolarsslFedoraChecker
poppler = cve_bin_tool.checkers.poppler:PopplerChecker
postgresql = cve_bin_tool.checkers.postgresql:PostgresqlChecker
ppp = cve_bin_tool.checkers.ppp:PppChecker
privoxy = cve_bin_tool.checkers.privoxy:PrivoxyChecker
procps_ng = cve_bin_tool.checkers.procps_ng:ProcpsNgChecker
proftpd = cve_bin_tool.checkers.proftpd:ProftpdChecker
pspp = cve_bin_tool.checkers.pspp:PsppChecker
pure_ftpd = cve_bin_tool.checkers.pure_ftpd:PureFtpdChecker
putty = cve_bin_tool.checkers.putty:PuttyChecker
python = cve_bin_tool.checkers.python:PythonChecker
qt = cve_bin_tool.checkers.qt:QtChecker
quagga = cve_bin_tool.checkers.quagga:QuaggaChecker
radare2 = cve_bin_tool.checkers.radare2:Radare2Checker
radvd = cve_bin_tool.checkers.radvd:RadvdChecker
rdesktop = cve_bin_tool.checkers.rdesktop:RdesktopChecker
rsync = cve_bin_tool.checkers.rsync:RsyncChecker
rsyslog = cve_bin_tool.checkers.rsyslog:RsyslogChecker
rtl_433 = cve_bin_tool.checkers.rtl_433:Rtl433Checker
rust = cve_bin_tool.checkers.rust:RustChecker
samba = cve_bin_tool.checkers.samba:SambaChecker
sane_backends = cve_bin_tool.checkers.sane_backends:SaneBackendsChecker
seahorse = cve_bin_tool.checkers.seahorse:SeahorseChecker
shadowsocks_libev = cve_bin_tool.checkers.shadowsocks_libev:ShadowsocksLibevChecker
snort = cve_bin_tool.checkers.snort:SnortChecker
sofia_sip = cve_bin_tool.checkers.sofia_sip:SofiaSipChecker
spice = cve_bin_tool.checkers.spice:SpiceChecker
sqlite = cve_bin_tool.checkers.sqlite:SqliteChecker
squashfs = cve_bin_tool.checkers.squashfs:SquashfsChecker
squid = cve_bin_tool.checkers.squid:SquidChecker
strongswan = cve_bin_tool.checkers.strongswan:StrongswanChecker
stunnel = cve_bin_tool.checkers.stunnel:StunnelChecker
subversion = cve_bin_tool.checkers.subversion:SubversionChecker
sudo = cve_bin_tool.checkers.sudo:SudoChecker
suricata = cve_bin_tool.checkers.suricata:SuricataChecker
sylpheed = cve_bin_tool.checkers.sylpheed:SylpheedChecker
syslogng = cve_bin_tool.checkers.syslogng:SyslogngChecker
sysstat = cve_bin_tool.checkers.sysstat:SysstatChecker
systemd = cve_bin_tool.checkers.systemd:SystemdChecker
tcpdump = cve_bin_tool.checkers.tcpdump:TcpdumpChecker
thrift = cve_bin_tool.checkers.thrift:ThriftChecker
thttpd = cve_bin_tool.checkers.thttpd:ThttpdChecker
timescaledb = cve_bin_tool.checkers.timescaledb:TimescaledbChecker
tinyproxy = cve_bin_tool.checkers.tinyproxy:TinyproxyChecker
tor = cve_bin_tool.checkers.tor:TorChecker
tpm2_tss = cve_bin_tool.checkers.tpm2_tss:Tpm2TssChecker
transmission = cve_bin_tool.checkers.transmission:TransmissionChecker
trousers = cve_bin_tool.checkers.trousers:TrousersChecker
unbound = cve_bin_tool.checkers.unbound:UnboundChecker
unixodbc = cve_bin_tool.checkers.unixodbc:UnixodbcChecker
upx = cve_bin_tool.checkers.upx:UpxChecker
util_linux = cve_bin_tool.checkers.util_linux:UtilLinuxChecker
varnish = cve_bin_tool.checkers.varnish:VarnishChecker
vsftpd = cve_bin_tool.checkers.vsftpd:VsftpdChecker
webkitgtk = cve_bin_tool.checkers.webkitgtk:WebkitgtkChecker
wget = cve_bin_tool.checkers.wget:WgetChecker
wireshark = cve_bin_tool.checkers.wireshark:WiresharkChecker
wolfssl = cve_bin_tool.checkers.wolfssl:WolfsslChecker
wpa_supplicant = cve_bin_tool.checkers.wpa_supplicant:WpaSupplicantChecker
xerces = cve_bin_tool.checkers.xerces:XercesChecker
xml2 = cve_bin_tool.checkers.xml2:Xml2Checker
xscreensaver = cve_bin_tool.checkers.xscreensaver:XscreensaverChecker
zeek = cve_bin_tool.checkers.zeek:ZeekChecker
zlib = cve_bin_tool.checkers.zlib:ZlibChecker
znc = cve_bin_tool.checkers.znc:ZncChecker
zsh = cve_bin_tool.checkers.zsh:ZshChecker
